####################################################
#####-----##############-$-#########################
#####-----##############-?----------------##########
#####@--------------####---##############*##########
#####-----#########-####***##############-##########
#####-----#########-###-----#############-##########
###################-##-------############-##########
###################----@---@---#######-------#######
###################-------------######-------#######
###################-------------######-------#######
###################-------------------------@#######
#########-----------------------######-------#######
#########-#########-------------######---!---#######
#########-#########-------------######-------#######
#########-#########-------------#########-##########
#########-#########-------------#########-##########
#########-###############-###############-##########
########---##############-###############-##########
########----------------------------------##########
########---##############-##########################
#########################-##########################
#########################=##########################