##########~#########################################
#######-------#######--@--#################-@-######
#######-------#######-----#################---######
#######-------########---###################-#######
###########---########---###############-----#######
###########---#######------#############-###########
###########---#######--!---#############-###########
############-########------#############-###########
############*########--------------------###########
############-#########---#####-#########-###########
############-#########---#####-#########-###########
############-------------####---########-###########
######################---####-@-######-----#########
######################---#############--?--#########
#############------------------------------#########
#############-----####---#############-----#########
#############-----####---#############---@-#########
#######-@-###--*--####---###########################
#######@-@#####-######---###########################
#######---#####-######---###########################
#######---------######---###########################
#######################=############################
