##########~#########################################
#######-------########----#################---######
#######-------########----#################---######
#######-------#########--###################-#######
###########---#########--###############-----#######
###########---#######------#############-###########
###########---#######------#############-###########
############-########------#############-###########
############-########--------------------###########
############-##########--#####-#########-###########
############-##########--#####-#########-###########
############-------------####---########-###########
#######################--####---######-----#########
#######################--#############-----#########
#############------------------------------#########
#############--*--#####--#############-----#########
#############-----#####--#############-----#########
#######---###--*--#####--###########################
#######---#####-#######--###########################
#######---#####-#######--###########################
#######---------#######--###########################
#######################==###########################
