####################################################
#####-----##############-$-#########################
#####-----##############------------------##########
#####---------------####---##############-##########
#####-----#########-####***##############-##########
#####-----#########-###-----#############-##########
###################-##-------############-##########
###################------------#######-------#######
###################-------------######-------#######
###################-------------######-------#######
###################--------------------------#######
#########-----------------------######-------#######
#########-#########-------------######-------#######
#########-#########-------------######-------#######
#########-#########-------------#########-##########
#########-#########-------------#########-##########
#########-###############-###############-##########
########---##############-###############-##########
########----------------------------------##########
########---##############-##########################
#########################-##########################
#########################=##########################