####################################################
########################-$-#########################
########################---#########################
########################---#########################
########################---#########################
#######################-----########################
######################-------#######################
####################-----------#####################
###################-------------####################
###################-------------####################
###################-------------####################
###################-------------####################
###################-------------####################
###################-------------####################
###################-------------####################
###################-------------####################
#########################-##########################
#########################-##########################
#########################-##########################
#########################-##########################
#########################-##########################
#########################=##########################