######~#############################################
######-#############################################
######-##############--@@@--#############-@-########
######-#############---------############---########
######-#############---------############---########
######-------*---###---------#############-#########
##########-#####-###----!----#############-#########
#########---####-###---------#############-#########
#########-@-####-###---------#############-#########
################-###---------###########-----#######
##@-------######-#######-###############--?--#######
##-------------------------------------------#######
##@-------######-#######-###############-----#######
################-#######-###############-----#######
################-#######-################-##########
######--@--#####-#######-################-##########
######-----#####-######---##############-------#####
######-----------------------------------------#####
######-----############---##############-------#####
######--@--#############-###############----@--#####
########################-###############-------#####
########################=###########################