######~#############################################
######-#############################################
######-##############-------#############---########
######-#############---------############---########
######-#############---------############---########
######-------*---###---------#############-#########
##########-#####-###---------#############-#########
#########---####-###---------#############-#########
#########---####-###---------#############-#########
################-###---------###########-----#######
##--------######-#######-###############-----#######
##-------------------------------------------#######
##--------######-#######-###############-----#######
################-#######-###############-----#######
################-#######-################-##########
######-----#####-#######-################-##########
######-----#####-######---##############-------#####
######-----------------------------------------#####
######-----############---##############-------#####
######-----#############-###############-------#####
########################-###############-------#####
########################=###########################