######~#############################################
######-#############################################
######-##############--@@@--#############-@-########
######-#############---------############---########
######-#############---------############---########
######-------*---###---------#############-#########
##########-#####-###----!----#############-#########
#########-?-####-###---------#############-#########
#########-@-####-###---------#############-#########
################-###---------###########-----#######
##@-------######-#######-###############--?--#######
##--!----------------------------------------#######
##@-------######-#######-###############-----#######
################-#######-###############-----#######
################-#######-################-##########
######--@--#####-#######-################-##########
######-----#####-######---##############-------#####
######-!---------------------------------------#####
######-----############---##############-------#####
######--@--#############-###############----?--#####
########################-###############-------#####
########################=###########################