##########~#########################################
#######-------########-@@-#################-@-######
#######-!-----########----#################---######
#######-------#########--###################-#######
###########---#########--###############-----#######
###########---#######----?-#############-###########
###########---#######--!---#############-###########
############-########------#############-###########
############-########--------------------###########
############-##########--#####-#########-###########
############-##########--#####-#########-###########
############-------------####---########-###########
#######################--####---######-----#########
#######################--#############--?--#########
#############------------------------------#########
#############--*--#####--#############-----#########
#############--!--#####--#############---@-#########
#######-@-###--*--#####--###########################
#######@-@#####-#######--###########################
#######---#####-#######--###########################
#######---------#######+-###########################
#######################==###########################
