##########~#########################################
#######-------#######--@--#################-@-######
#######-!-----#######-----#################---######
#######-------########---###################-#######
###########---########---###############-----#######
###########---#######----?-#############-###########
###########---#######--!---#############-###########
############-########------#############-###########
############-########--------------------###########
############-#########---#####-#########-###########
############-#########---#####-#########-###########
############-------------####---########-###########
######################---####---######-----#########
######################---#############--?--#########
#############------------------------------#########
#############--*--####---#############-----#########
#############--!--####---#############---@-#########
#######-@-###--*--####---###########################
#######@-@#####-######---###########################
#######---#####-######---###########################
#######---------######---###########################
#######################=############################
