####################################################
#####-----##############-$-#########################
#####--!--##############------------------##########
#####@--------------####---##############*##########
#####--!--#########-####***##############-##########
#####-----#########-###-----#############-##########
###################-##-------############-##########
###################----@---@---#######-------#######
###################-------------######---!---#######
###################----!---?----######-------#######
###################-------------------------@#######
#########-----------------------######-------#######
#########-#########-------------######---!---#######
#########-#########-------------######-------#######
#########-#########-------------#########-##########
#########-#########-------------#########-##########
#########-###############-###############-##########
########---##############-###############-##########
########-!--------------------------------##########
########---##############-##########################
#########################-##########################
#########################=##########################